╔════════════╗ ╔════════════╗
║............║ ║............║
║.╔══╗.╔═══╗.║ ║.╔═══╗.╔══╗.║
║●║  ║.║   ║.║ ║.║   ║.║  ║●║
║.╚══╝.╚═══╝.╚═╝.╚═══╝.╚══╝.║
║...........................║
║.╔══╗.╔╗.╔═══════╗.╔╗.╔══╗.║
║.╚══╝.║║.╚══╗ ╔══╝.║║.╚══╝.║
║......║║....║ ║....║║......║
╚════╗.║╚══╗ ║ ║ ╔══╝║.╔════╝
     ║.║╔══╝ ╚═╝ ╚══╗║.║     
     ║.║║           ║║.║     
     ║.║║ ╔═-----═╗ ║║.║     
═════╝.╚╝ ║GGGGGGG║ ╚╝.╚═════
      .   ║GGGGGGG║   .      
═════╗.╔╗ ║GGGGGGG║ ╔╗.╔═════
     ║.║║ ╚═══════╝ ║║.║     
     ║.║║           ║║.║     
     ║.║║ ╔═══════╗ ║║.║     
╔════╝.╚╝ ╚══╗ ╔══╝ ╚╝.╚════╗
║............║ ║............║
║.╔══╗.╔═══╗.║ ║.╔═══╗.╔══╗.║
║.╚═╗║.╚═══╝.╚═╝.╚═══╝.║╔═╝.║
║●..║║........S........║║..●║
╚═╗.║║.╔╗.╔═══════╗.╔╗.║║.╔═╝
╔═╝.╚╝.║║.╚══╗ ╔══╝.║║.╚╝.╚═╗
║......║║....║ ║....║║......║
║.╔════╝╚══╗.║ ║.╔══╝╚════╗.║
║.╚════════╝.╚═╝.╚════════╝.║
║...........................║
╚═══════════════════════════╝
